┌───────────┐
│. . . . . o│
│.┌───┐.┌─┐.│
│.└───┘.└─┘.│
│. . . . . .│
└─┐.┌─=─┐.┌─┘
  │.│M M│.│  
┌─┘.└───┘.└─┐
│. . .C. . .│
│.┌───┐.┌─┐.│
│.└───┘.└─┘.│
│o . . . . .│
└───────────┘