┌───────────┐     ┌───────────┐
│o . . . . .│     │. . . . . o│
│.┌─┐.┌───┐.│     │.┌───┐.┌─┐.│
│.└─┘.└───┘.└─────┘.└───┘.└─┘.│
│. . . . . . . . . . . . . . .│
└─┐.┌───┐.┌────=────┐.┌───┐.┌─┘
  │.│   │.│  M M M  │.│   │.│  
┌─┘.└───┘.└─────────┘.└───┘.└─┐
│. . . . . . . C . . . . . . .│
│.┌───┐.┌─┐.┌─────┐.┌─┐.┌───┐.│
│.└───┘.└─┘.│     │.└─┘.└───┘.│
│o . . . . .│     │. . . . . o│
└───────────┘     └───────────┘