  ┌───────────┐ ┌─────────────────────────┐ ┌───────────┐  
  │. . . . . .│ │. . . . . . . . . . . . .│ │. . . . . .│  
  │.┌───────┐.│ │.┌───=───┐.┌─┐.  ┌───┐  .│ │.┌──┐  ┌─┐.│  
──┘.│ ┌─────┘.└─┘.│ M M M │.└─┘.┌─┘ o └─┐.└─┘.│  └─┐│ │.└──
 . .│ │. . . . . .│ ┌┐ ┌┐ │. . .│ ┌─ ─┐ │. . .│ ┌┐ └┘ │. . 
──┐.│ └─────┐.┌─┐.│ │└─┘│ │.┌─┐.│ │   │ │.┌─┐.│ │└─┐  │.┌──
  │.└───────┘.│ │.└─┘ C └─┘.│ │.└─┘   └─┘.│ │.└─┘  └──┘.│  
  │o . . . . .│ │. . . . . .│ │. . . . . .│ │. . . . . o│  
  └───────────┘ └───────────┘ └───────────┘ └───────────┘  