  ┌───────────┐ ┌─────────────────────────┐ ┌───────────┐  
  │. . . . . .│ │. . . . . . . . . . . . .│ │. . . . . .│  
  │.┌───────┐.│ │.┌───────┐.┌─┐.  ┌───┐  .│ │.┌──┐  ┌─┐.│  
──┘.│ M ┌───┘.└─┘.│ ┌┐ ┌┐ │.└─┘.┌─┘ o └─┐.└─┘.│  └─┐│ │.└──
 . .│ M  . . . . .│ │└─┘│ │. C .│ ┌─ ─┐ │. . .│ ┌┐ └┘ │. . 
──┐.│ M └───┐.┌─┐.│ │   │ │.┌─┐.│ │   │ │.┌─┐.│ │└─┐  │.┌──
  │.└───────┘.│ │.└─┘   └─┘.│ │.└─┘   └─┘.│ │.└─┘  └──┘.│  
  │o . . . . .│ │. . . . . .│ │. . . . . .│ │. . . . . o│  
  └───────────┘ └───────────┘ └───────────┘ └───────────┘  